WWWWWWWWWWWWWWWWWWWWWW
W
W   W      WWWWW
W   W      W
WWWWWWWWWWWWWWW    WWWW
W                     W
W        W            W
W        W            W
WWWWWWWWWWWWWWWWWWWWWWW